000000000
000000000
000000000
000000000
100000001
010000010
001111100
000101000
000010000
000000000
000000000
000000000
30
300