000000000
000000000
000000000
000010000
000010000
000011111
111110000
000010000
000010000
000000000
000000000
000000000
30
300