000000000
000000000
000000000
000010000
000101000
001000100
010000010
100000001
000000000
000000000
000000000
000000000
15
300