000000000
000000000
000000000
000000000
000010000
000111000
000010000
000000000
000000000
000000000
100000001
110000011
30
100